Encoder	KEYWORD1
HallEffectEncoder	KEYWORD1
Motor	KEYWORD1
PIDController	KEYWORD1
QuadratureEncoder	KEYWORD1
RLUtil	KEYWORD1
StepperMotor	KEYWORD1
TrackingLoop	KEYWORD1
pullup	KEYWORD2
process	KEYWORD2
reset	KEYWORD2
getTicks	KEYWORD2
getValue	KEYWORD2
begin	KEYWORD2
setDirection	KEYWORD2
reverse	KEYWORD2
setDefaultOnZero	KEYWORD2
output	KEYWORD2
outputBool	KEYWORD2
disableOutput	KEYWORD2
enableOutput	KEYWORD2
getNumPins	KEYWORD2
setBounded	KEYWORD2
setOutputRange	KEYWORD2
update	KEYWORD2
getIntegratorValue	KEYWORD2
clamp	KEYWORD2
lerp	KEYWORD2
slerp	KEYWORD2
step	KEYWORD2
setRPM	KEYWORD2
getCurrentSteps	KEYWORD2
getVelocityEstimate	KEYWORD2
getAccelEstimate	KEYWORD2
setIntegratorBounds KEYWORD2
setTolerance        KEYWORD2